1111111111111111111111111111111111111111111111111111111111111111
100000000000000000000000000G0000000000000000000H1000000000000001
10P00000000100000000000000000000000000000000000010000233L3200001
1000000000010000000000000000000000000000000000001000030000300001
1111111111110000000000000000000000000000000000001000030CK0300001
1W00000001010000000000000000000000000000000000001000030CC0300001
10000000010L0000000000000000000000000000000000001000030000300001
100000000101000000000000000G000000000000000000001000023333200001
10000d0001011111111111111111111111100000000000001000000000000001
100000000101000000000000000000000010G0000G0000G01000000k00000001
1000000001010000000000000000000000100000000000001000000000000001
10000000k1010000000000000G00000000100000000000001000G00F000G0001
1L11111111010000000000000000000000100000000000001000000000000001
10000000010000000000000000000000001000000k0000001000000000000001
10000000010100000000000000G0000000111111111111111000000000000001
10000000011100000000000000000000000000000000010000d00d00d00d0001
1000F00000000000000000000000000000000000000001000000000000000001
100000000111000000000000000G0000000000000000010000000G00G0000001
1000000000100000000000000000000000000000000001000111111111111001
1000000000100000000000000000000000000000000001000000000H00000001
100d0000001000000000000000000000000000000000010F01111111111110F1
1000000000100000000000000000000000000000000001000000000000000001
1000000000100000000000000000000111111101111111000000000000000001
11111111111000000000000000000001G00000000000G10000G00000000G0001
1000G00000100000000000000000000100000000000001000000000000000001
10000000001L11111111111111111111000000000000010000G00000000G0001
10000000000G0000000000000000000100000000000001000000000000000001
10000000000000000000000000000001k00000000000k10000d00000000d0001
1000000000000000000000000000000100000000000001000000000000000001
10000000000000000000000000000001111111111111110000G00000000G0001
10000000000000000000000000000001000000H010H00L000000000000000001
1HG00000000000000000000000000001000000H0100001000000000000000001
10G0000000000000000000000G00000L00000kH01kH0010000G00000000G0001
1HG00000000000000000000000000001000000H0100001000000000000000001
10000000000000000000000000000001000000H010H00100000000dd00000001
1000000000000000000000000000000111111111111111100000000000000001
1111111111111100001111111111111140000000000000000000000000000001
1000000000000000000000000000000100000000000000000000000000000001
10000d0000000000000000000d00000100000000111111100000000000000001
1000000000000000000000000000000100000000100000000000000000000001
100000000000000000000000000000010000000010000000000G000000000001
100000000000000G0000000000000001000S0000100000000000000000000001
100000000000000k00000000000000010000000010000G00000k0000000G0001
1000000000000000000000000000000100000000100000000000000000000001
100000d000000000000000000d00000100000000100000000000000000000001
100000000000000000000000000000010000000010000000000G000000000001
100000000000000000000000000000k100000000100000000000000000000001
11111111111111L11111111111111111111L1111111111111111111111111111
1000000000000000000000000001000000100000000000000d000000000000H1
1111011111111111111111111111000H00111111111100000000000000000001
1000000000000010000000000010000000000000000100000000000000000001
10010101111101110000011111111110000d00000001FFFF1111111111100001
100101001000000100d001000000001000000011110111111000000000100001
100100001000000101010101111110100G000010010010001001000000100001
100111001000H000000001010000001000000010000000001001000G00100001
100101001111111101010101G111111111111110000000011001000G00100001
1001010G10Hk0H01k0d001010000000000000000000G00000001000000000001
1000010010000001111111011111111111111110000000011111111111111111
111101001L111101000000000000000100000010000000001000000000000001
10000100101000010000000000H0000100000010000000001011111111111101
10d0010010100001000000000010000000G00011111111111010000000000001
10000100101000010000000000H0000100000000d00000000010000000000001
100001000010000000000000000000010000001111111111111kd00000000001
1111111111111111111111111111111111111111111111111111111111111111
