11111111111111111111111111111111111111111111111111111111111111111111111111111111111111111111111111111111111111111111111111111111
1P0000000000000000000000000000000000000000000000000000000000000110C010G00G0100010G00G010C010G00G0100010G000G011000000000000000k1
10000000000000000000000000000000000000000000000000000000000000011000100000010001000000100010000001000100000001100000000000000001
10000000000000000000000000000000000000000000000000000000000000011000111111110001111111100011111111000111111111100000000K00000001
10000000000000000000000000000000000000000000000000000000000000011000000000000000000000000010000000000000000001100000000000000001
100000000000000000000000000000000000000000000000000000000000000110000000000000000000000000100000000000000000k1100000000000000001
111111111111111000001111111111111111111000011111111111111111111110000000000000000000000000100000000000000000011L1111111111111111
10000000000000100000100000000000000000100000000000000000000000011000111111110001111111100011111111000111111111101111111111111111
1000000000000010000010000000000000000010000000000000000000000001100010000001000100000010k010000001000100000010000000000000000001
1000000000000010000010000000000000000010000000000000000000000001100010G00G0100010G00G0100010G00G0100010G00G010000000000000000001
1000000000000010000010000000000000000010000000000G000k00000000011000100000010001000000100010000001000100000010000000000000000001
10000000000000100000100000000000000000100000000000000000000000011000111111110001111111111111111111000111111110000000000000000001
10000000000000000000100000000000000000100000000000000000000000011000000000000000000000000010000000000000000000000000000000000001
10000000001111111111110011111111111100100000000000000000000000011000000000000000000000000010000000000000000000000000000000000001
10000000001000000000000000000000000100000000000000000000000000011000000000000000000000000010000000000000000000000000000000000001
10111111111000000000000000000000000111111111111111111111111111111000111111110001111111100011111111000111111110001111111111111111
10100000001000000000000000000000000111111111100000000000000000011000100000010001000000100010000001000100000010001000000010000001
1010000000100000000000000000000000010000000010000000000000000001100010G00G0100010G00G0100010G00G0100010G00G0100010G00G00100C0001
10000000001000000000000000000000000100000000100000000000000000011000100000010001000000100010000001000100000010001000000010000001
11100000001000000000000000000000000100000000100000000000000000011000111111110001111111100011111111000111111110001111111110000001
11111111111000000000000000000000000100000000111111111111111111111000000000000000000000100000000000000000000010000000000000000001
10000000000000000000000000000000000000000000000000000000000000000000000000000000000000100000000000000000000010000000000000000001
10000000000000000000000000000000000000000000000000000000000000000000000000000000000000100000000000000000000010000000000000000001
10011111111000000000000000000000000100000000111111111111111111111000000000000000000000100000000000000000000010000000000000000001
100000000010000000000000000000000001000000001000000000000000000110001111111100011111111111111111L1000111111110001111111100000001
100000000G1000000000000000000000000100000000100000000000000000011000100000010001000000100000000001000100000010001000000100000001
1000000000100000000000000000000000010000000010000000000000000001100010G00G0100010G00G010H000H0kA0100010G00G0100010G00G0100000001
11111110001111111111110011111111111111111111111111111111111111111000100000010001000000100000000001000100000010001000000100000001
10000000000000000000010011111111111111111111111111111111111111111000111111110001111111111111111111000111111110001111111100000001
1000111111110000000001001000000000100000000000000000000010H000C1100000000000000000000000000000CCC1000000000000000000000000000001
1000000001W100000000010000000000001000000000000000000000100000011000111111110001111111100011111111000111111110001111111100000001
100000000L0100000000010001111111001111111111100011111000111100011000100000010001000000100010000001000100000010001000000100000001
1111111111111111111111111100000000000000000000001000100000000001100010G00G0100010G00G0100010G00G0100010G00G0100010G00G0100000001
111111111111111111111100000111111111111111111111100011110000d001100010000001000100000010H010000001000100000010001000000100000001
11111111111111111111110011110000000C00001111111110000001000000011000111111110C011111111000111111110C0111111110C01111111100000001
100000000000000000000100000001111111111110000G001111100100000001111111111111111111111111111111111111111111111111111111111111L111
10011111110111110100010011111111111111111011111010000d000000d0011111111111111111111111111111111111111111111111111111111111110111
1001000000000001011111001000000000C011111010000010000000000000011000000000000000001000000000000000000000000000000000000000000001
10010111110100010000000000011111111111111011100011111011111111111000000000000000001000000000000000000000000000000000000000000001
10G1010001010001111111001111111111111G00000G100000000000000000011000000000111111111001111111111111111111111111111111111111111111
1111010H010100000000G10010000000000010111110111111101000000G000110000000001000000000000000000010000X0000000000000000000X00000001
1001010001010000000001001001d000d100101000101000000010111111111110000000001000000000000000000010F0F0F0F0F0F0F0F0F0F0F0F0F0F0F001
1001010000011111111111001001000001001010K0101001111110100000C001100000000010000000000000000000100000000000C00000000000000k000001
1001010H010100000000010010010000010010100k1010010C0000000000000110000000001000000000000000000010F0F0F0F0F0F0FdF0F0F0F0F0F0F0F001
100101111111000G00G0010010010A0S010010111L10100100000001111110111000000000100000000000000000001000000000000000000000000000000001
10d0000000000000000001001001000001001G00000G1001000C00010000000110000000001000000000000000000010F0F0F0F0F0F0F0F0F0F0F0F0F0F0F001
100111111100001111111100100111111100111111111001111111110000H001100000000010000000000000000000100000000000d0000000000C0d00000001
100000000100001000000000000000000000111111111000000000000000000111111111111000000000000000000011110000FFFFFFFFFFF00F0F0F0F0F0F01
1G0000C0010k00100000000d0000000000001111111111111111111100000C0110000000000000000000000000000000000000FFFFFFFFFFF00F0F0F0F0F0F01
111111111111111111111111111111111111111111111111111111111111111110000000000000000000000000000000000000FFFFFFFFFFF00F0F0F0F0F0F01
111111111111111111111111111111111111111111111111111111111111111110011111111000000000000000000011110000FFFFFFFFFFF00F0F0F0F0F0F01
1000000000000000000000100000000000000000010000000000000000000000000111111110000000000000000000100000000000d000000000000d000000A1
100d00000000000000d000100d0000000000000001000000000000000000000000011111111000000000000000000010FFFFFFFFFFFFFFFFFFFFFFFFFFFFFFA1
1000000000000000000000100000000000000d0001000000000000000000000111111111111000000000000000000010000000000000000000000000000000A1
100000000000000000000010000000000000000001000000000000000000000111111111111000000000000000000010F0F0F0F0F0F0F0F0F0F0F0F0F0F0F0F1
100000000000000000000010000000000000000001000000000000000000000111111111111000000000000000000010d000000000000G000000000G00000001
1000000000CX00000000000000000000CG00000000000000000000000000000111111111111000000000000000000010F0F0F0F0F0F0F0F0F0F0F0F0F0F0F0F1
100000000000000000000000000000000000000000000000000000000000000111111111111000000000000000000010d000000000000G000000000G00000001
100000000000000000000010000000000000000001000000000000000000000111111111111111111111001111111110F0F0F0F0F0F0F0F0F0F0F0F0F0F0F0F1
1000000000000000000000100000000000000000010000000000000000000001111111111111111111110011111111100000000000000S0000C0000000000001
1000000000000000000000100000000000000000010000000000000000000001111111111111111111110011111111100FFFFFFFFFFFFFFFFFFFFFFFFFFFF0X1
100d00000000000000d000100d00000000000d0001000000000000000000000111111111111111111111001111111110000000G0000000000000000000000001
1000000000000000000000100000000000000000010000000000000000000001111111111111111111110011111111100FFFFFFFFFFFFFFFFFFFFFFFFFFFFFF1
1111111111001111111111111111111001111111111111111111100111111111111111111111111111110011111111100F000F000F000F000000000000000001
1000000000000000000000100000000000000000010000000000000000000001100000000000000000010011111111100F0F0F0F0F0F0F000000000001111111
100d000000000000000d00100d000000000000d0010000d0000000000000d001100S00000000000000010011111111100F0F0F0F0F0F0F0000G0000001000001
1000000000000000000000100000000000000000010000000000000000000001100400000000000000010011111111100F0F0F0F0F0F0F00000000000L000001
1000000000000000000000100000000000000000010000000000000000000001100A00000000000000000011111111100F0F0F0F0F0F0F0000G000000100K001
1C0000000000000000000010000000000000000001000000000000000000000110000000000000000001001111111110000F000F000F000000000000010000k1
1C000000000000000000001000000000000000000100000000000000000000011111111111111111111100111111111111111111111111111111111111111111
1C00000000X000000000000000000CG0000000000000000000000GC0000000011000000000000000000000000000000000000000000000000000000000000001
10000000000000000000000000000000000000000000000000000000000000011000000000000000000000000000000000000000000000000000000000000001
10000000000000000000001000000000000000000100000000000000000000011000011111111111111111111111111100001111111111111111111111000001
1k000000000000000000001000000000000000000100000000000000000000011000010000000000000000000000000000000000000000000000000001000001
10000000000000000000001000000000000000000100000000000000000000011000010000000000000000X00000000000000000000000000000000001000001
100d00000000000000d0001000d00000000000d001000d00000000000000dC011000010000000111111111111111110100001000000000000X00000001000001
10000000000000000000001000000000000000000100000000000000000000011000010000000100000000000000000100001000000000000000000001000001
1111111111001111111111111111110011111111111111111111100111111111100001000X00010000000X000000000100001000000000000000000001000001
100000000000000000000010000000000000000001000000000000000000000110000100000001000000000000000001000010000000X0000000000001000001
100d000000000000000000100000000000000000010d00000000000000000dC11000010000000100C0C000C000C00001000010000000000000X000000100X001
1000000000000000000d0010d00000000000000d010000000000000000000001100001000000010000000000000000010000100000000000000000C001000001
1000000000000000000000100000000000000000010000000000000000000001100001000X000111011111111111111100001000000000000000000001000001
100000000000000000000010000000000000000001000000000000000000000110000100000001000000000000000000000010000000000000C000C001000001
1000000000000000000000100000000G000000000100000000000000000000011000010000000100000000000000000000001000000000000000000001000001
10000000000X00000000000000000000000000000000000000000000000000011000010000000111111111111111111111111111111111111111111111000001
10000000000000000000000000000000C00000000000000000000CG0000000011000010000000000000000000001000100000000000000000000000001000001
100000000000000000000010000000000000000001000000000000000000000110000100000000000000000000010001000000X000000000000000000100X001
1000000000000000000000100000000000000000C1000000000000000000000110000100000000000000000000010001000000000000000k0000000001000001
1000000000000000000000100000000000000000010000000000000000000001100001000000X0000000X000000000010000000X000000000000000001000001
100d00000000000000d000100d0000000000000d0100d000000000000000dc011000010000000000000000000000000100000000000000000000000001000001
10000000000000000000001000000000000000C00100000000000000000000011000010000000000000000000001000000000000000000000000000001000001
11111111100111111111111111111111001111111111111111110011111111111000010000000000000000000001000000000000000000000000000001000001
1000000000000000000000100000000000000000010000000000000000000001100001L111111111111111111111111111111111111111111111111111000001
100d00000000000000d000100d0000000000000d01000d00000000000000d0011000010000000000000010000000000000000000000000000000000001000001
10000000000000000000001000000000000000000100000000000000000000011000010000000000000000000000000000X00000000000000000000001000001
10000000000000000000001000000111110000000100000000000000000000011000010000000000000000000000000000000000000000000000000001000001
10000000000000000000001000000100010000000100000000000000000000011000010000000000000000000000000000000000000000000111L10001000001
100000000XC00000000000100000010K0100000001000000000000000000000110000100000000000000000000X0000000X00000000B00000100k10001000001
10000000000000000000000000000100k10000000000000000000X0000000001100001000000000000000000000000000000000000000000010K010001000001
1000000000000000000000000000011L110000000000000000000000000000011000010000000000000000000000000000000000000000000100010001000001
10000000000000000000001000000000000000000100000000000000000000011000010000000000000000000000000000X0000000000000011111000100CC01
1000000000000000000000100000000000000000010000000000000000000001100001000000000000000100000000000000000000000000000000000100AA01
100d000000000000000d0010000000000000000001000000000000000000d0011111111111111111111111111111111111111111111111111111111111111111
1000000000000000000000100d0000000000000d01000d0000000000000000011111111111111111111111111111111111111111111111111111111111111111
1000000000000000000000100000C000000C00000100000000000000000000011111111111111111111111111111111111111111111111111111111111111111
1L111111111111111111111111111111111111111111111111111111111111111111111111111111111111111111111111111111111111111111111111111111
10000100000010000000000000000000000000000000000000000000000F00000x00001S0000000000000000000000000000000000000000000000FF00000001
1000010000000100000000000000000000000000000000000001000000000F000000000100000000000000000000000000XkX00000000000000000FF0000d001
1000010000000010000000000S0000G0000000000000000000010000G00F00000000000010000000000000000000000000000000000000000000001111111001
100001000000000100000000000000000000000000000000d001000000000F000000000001000000000d0000000000000000000000000d000000001000001001
10000100000000001000000011111111111110000000000000010000000F00000000000000100000000000000000000000G00000000000000000001000001001
1000010000000G0001000000100G0000G0001000000000000001000000000F000000000000001000000000000000000000000000000000000000001000001001
10000100000000000010000011111111111110000000000000010000000F000000000000000001G0000000X00000000000000000000000X0000000100K001001
10000000000000000001000FFFFFFFFFFFFFFF000000X0000001000000000F000000000000000000000000000000000000000000000000000000001000001001
10000000000000000000100000000000000000000000000000010000000F000000000000000000010000000000000000000000000000000000000A1000001001
10000000000000000000010000000000000000000000000000010000d0000F00000d000000000000FFFFFFFFFFFFFFFFFFFFFFFFF0FFFFFFFFFFFF100000L001
100000000000000000000000000000000d0000000000000000010000000F000000000000000000010000000000000000000000000000000000000A1000001001
1000010000000000000001000000000000000000000000000001000000000F000000000000000000000X00000000000000000000d00000000000001000001001
10000100000000000000100FFFFFFFFFFFFFFF000000000000010000000F000000000000000001G0000000001000000000000000000000000000001000001001
1000010000000G00001000001111111111111000000000000001000000000F0000000000000010000000000010000000000F0000000000F0000000100K001001
10000100000000000100000010G0000000G010000000000000010000000F00000000000000010000000000001000000000000000000000000000001000001001
1000010000000000100000001111111111111000000000000001000000000F000000000000100000000000001000000000000000d00000000000001000001001
10000100000000010000000000000000000000000000X00000010000000F0000000000000100000000X0000011111111111111111111111111111L1111111001
100001000000001000000000000000000000000000000000d001000G00000F000000000010000000000000001000000000000000000000000000000000000001
100001000000010000000000S000000G000000000000000000010000000F000000000001000000000000000010000000000000000000000000G00000000G0001
1005010000001000000000000000000000000000000000000000000000000F000X00001S00000000H000000H10000000k0000000000000000000000000000001
11111111111111111111111111111111111111111111111111111111111111111111111111111111111111111111111111111111111111111111111111111111
